########################
#       ##             #
##### ###  ######  #####
#       8   ######  #  #
# ########             #
# ###   ## ########## ##
#       ##         9 # #
##### ##############   #
#      ###   1     ### #
# ########      ##     #
# ########      ########
#       ##           # #
##### ##############   #
# #    #####    #### # #
#   ##   #           # #
########################
