########################
#       ##             #
##### ###  ######  #####
#           ######  #  #
# ########             #
# ###   ## ########## ##
#       ##           # #
##### ##############   #
#      ###         ### #
# ########      ##     #
# ########      ########
#       ##           # #
##### ##############   #
# #    #####    #### # #
#   ##   #           # #
########################
